11111111111111111111111111111111111111111111111111111111111
1P10C1E000000001C00000000000000000000000000000000000000C001
101001000000000110000000000F0000000000000000000000000000001
10100100000011000111111111111111111000000000000000000000001
1010F1C0000010000000000000000000001111110000000000000000001
10100111111111111111111111111111100000011111100000000000001
100000000000C10000001010000F0000000000000000011100000000001
1111110111111100F000100000000000100000000000F00010000000001
1C000101000001000000100000000000100000000000000000000000001
10000101000001000000100000000000100000100000000010000000001
10000101000001000000000000000000100000100001000111111000001
10000000000111000000000000000000111111111111000100000000001
10000000000100000000000000000000100000000000000100000000001
10000000000000000000000000000000100000000000000100000000001
10000001111111111111111111111111111111111111111100000000001
10000001C0000000000000000000000000000000000000000F000000001
100F0001000000000000000000000000000000000000000000000000001
11111111111111111111111111111111111111111111111111111111111
