1111111111111111111111111111111111111111111
1000000E00000000000000000000000000000000001
1000000000000000000000000000000000000000001
100011110011110C100000111100111100000000001
1000100000100000100000100000100100000000001
1000100000111100100000111100100100000000001
1000100000100000100000000100100100000000001
100011110011110C111100111100111100C00000001
1000000000000000000000000000000000000000001
1000111111111111111111111111111111000000001
1000000000000000000000000000000000000000001
100P000000000000C00000000000000000000000001
10000000000000000000000000000F0000000000001
1000000000000000000000000000000000000000001
10000000C00000000C00000000F0000000000000001
1000000000000000000000000000000000000000001
1000000000000C00000000000000000000000000001
1000000000000000000000000000000000000000001
1111111111111111111111111111111111111111111

