1111111111111111111111
11100000F01010000C0001
101000F0F0000C00000001
1CC00P00100C000F00E001
1000000000101000000001
1F0000001C000000C00C01
1000000C00001010000011
1000001001010000101001
1001000000001000000101
110000C000110001000001
10C00000001000C10F0001
1C0001C0F1000F00000011
1011000C01000000000F01
100001C0000000CF000001
100000010100F010F00001
100000100000CC0F0CC011
1111111111111111111111
